
 triptype = 'triptypes',
 usertable = 'usertables',
 account = 'accounts',
 contact = 'contacts',
 commandlogentry = 'commandlogentries',
 publisher = 'publishers',
 geocoding = 'geocodings',
 accounting = 'accountings',
 presentation = 'presentations',
 bid = 'bids',
 auctioninfo = 'auctioninfos',
 priceinfo = 'priceinfos',
 calendarentry = 'calendarentries',
 timerange = 'timeranges',
 bookingcalendar = 'bookingcalendars',
 accomodationresource = 'accomodationresources',
 destinationresource = 'destinationresources',
 eventresource = 'eventresources',
 tripofferresource = 'tripofferresources',
 roomcalendarentry = 'roomcalendarentries',
 roomcalendar = 'roomcalendars',
 roomlist = 'roomlists',
 transportresource = 'transportresources',
 review = 'reviews',
 hostresource = 'hostresources',
 tourist = 'tourists',
 languagelevel = 'languagelevels',
 guideresource = 'guideresources',
 guide = 'guides',
 agency = 'agencies',
 medialocation = 'medialocations',
 touristresource = 'touristresources',
 travelgroupresource = 'travelgroupresources',
 agencyaccomodation = 'agencyaccomodations',
 agencyevent = 'agencyevents',
 agencyguide = 'agencyguides',
 agencyhost = 'agencyhosts',
 agencytourist = 'agencytourists',
 agencytransport = 'agencytransports',
 agencytravelgroup = 'agencytravelgroups',
 agencytripoffer = 'agencytripoffers',
 agencyuser = 'agencyusers',
 mediadestinationresource = 'mediadestinationresources',
 agencyreview = 'agencyreviews',
 guidereview = 'guidereviews',
 agencybid = 'agencybids',
 agencymedialibrary = 'agencymedialibraries',
 agencydeal = 'agencydeals',
 agencyfavorite = 'agencyfavorites',
 agencyoffer = 'agencyoffers',
 date_ = 'date_s',
 guidebid = 'guidebids',
 guidedeal = 'guidedeals',
 guidefavorite = 'guidefavorites',
 guideoffer = 'guideoffers',
 touristbid = 'touristbids',
 touristdeal = 'touristdeals',
 touristfavorite = 'touristfavorites',
 touristoffer = 'touristoffers',
 touristreview = 'touristreviews',
 similarbytriptypeaccomodation = 'similarbytriptypeaccomodations',
 similarbytriptypedestination = 'similarbytriptypedestinations',
 similarbytriptypeevent = 'similarbytriptypeevents',
 similarbytriptypeguide = 'similarbytriptypeguides',
 similarbytriptypehost = 'similarbytriptypehosts',
 similarbytriptypetransport = 'similarbytriptypetransports',
 similarbytriptypetravelgroup = 'similarbytriptypetravelgroups',
 assocaccomodation = 'assocaccomodations',
 assochost = 'assochosts',
 assocguide = 'assocguides',
 assoctransport = 'assoctransports',
 assocevent = 'assocevents',
 assocdestination = 'assocdestinations',
 assoctravelgroup = 'assoctravelgroups'